######################################
#------------------------------------#
#------------------------------------#
#------------------------------------#
#------------------------------------#
#------------------------------------#
#-----#------------------------------#
#-----#------------------------------#
#-----#------------------------------#
#-----#------------------------------#
#-----#--------A----S----------------#
#-----#------------------------------#
#-----#------------------------------#
#-----#------------------------------#
#-----#------------------------------#
#------------------------------------#
#------------------------------------#
#------------------------------------#
#---------------------------------G--#
#------------------------------------#
######################################