1
5
####################################
#----------------------------------#
#----------------------------------#
#----------------------------------#
#----------------------------------#
#----#-----------#-----------#-----#
#----#-----------#-----------#-----#
#----#-----------#-----------#-----#
#----#-----i-----#------p----#-----#
#----#-----------#-----------#-----#
#----#-----------#-----------#-----#
#----#-----------#-----------#-----#
#----#-----------#-----------#-----#
#----#-----------#-----------#-----#
#----#-----------#-----------#-----#
#----#-----------#-----------#-----#
#----#-----------#-----------#-----#
#----------------------------------#
#----------------------------------#
#----------------------------------#
#-----------------G----------------#
#----------------------------------#
#----------------------------------#
####################################