######################################
#------------------------------------#
#------------------------------------#
#------------------------------------#
#------------------------------------#
#------------------------------------#
#-----#------------------------#-----#
#-----#------------------------#-----#
#-----#------------------------#-----#
#-----#------------------------#-----#
#-----#--------3----u----------#-----#
#-----#------------------------#-----#
#-----#------------------------#-----#
#-----#------------------------#-----#
#-----#------------------------#-----#
#------------------------------------#
#------------------------------------#
#------------------------------------#
#---------------------------------G--#
#------------------------------------#
######################################