6
2
####################################
#----------------------------------#
#----------------------------------#
#----------------------------------#
#----------------------------------#
#----------------------------------#
#---------2----------------G-------#
####################################