3
1
####################################
#----------------------------------#
#----------------------------------#
#----------------------------------#
#----------------------------------#
#--------2------------------G------#
####################################