######################################
#------------------------------------#
#------------------------------------#
#------------------------------------#
#------------------------------------#
#------------------------------------#
#-----#------------------------------#
#-----#------------------------------#
#-----#------------------------------#
#-----#------------------------------#
#-----#--------2----u----------------#
#-----#------------------------------#
#-----#------------------------------#
#-----#------------------------------#
#-----#------------------------------#
#------------------------------------#
#------------------------------------#
#------------------------------------#
#---------------------------------G--#
#------------------------------------#
######################################