3
1
####################################
#----------------------------------#
#----------------------------------#
#----------------------------------#
#----------------------------------#
#----------------------------------#
#----------------------------------#
#-------1----------------G---------#
####################################