3
1
####################################
#----------------------------------#
#----------------------------------#
#----------------------------------#
#----------------------------------#
#--------2o-----------------G------#
####################################