3
1
####################################
#----------------------------------#
#----------------------------------#
#----------------------------------#
#----------------------------------#
#----------------------------------#
#----------------------------------#
#-------1p---------------G---------#
####################################