6
2
####################################
#----------------------------------#
#----------------------------------#
#----------------------------------#
#----------------------------------#
#----------------------------------#
#---------2o---------------G-------#
####################################