10
1
#####################
#####################
#-------------------#
#-------------------#
#-------------------#
#-########-########-#
#-########-########-#
#-########-########-#
#-########-########-#
#-########-########-#
#3########-########1#
#i########-########p#
#-########1########-#
#-########p########-#
#-########-########-#
#-########-########-#
#---------G---------#
#####################