####################################
#----------------------------------#
#----------------------------------#
#----------------------------------#
#----------------------------------#
#----------------------------------#
#----------------------------------#
#----------------------------------#
#----#-----------------------#-----#
#----#-----------------------#-----#
#----#-----------------------#-----#
#----#-----------------------#-----#
#----#--------3----i---------#-----#
#----#-----------------------#-----#
#----#-----------------------#-----#
#----#-----------------------#-----#
#----#-----------------------#-----#
#----------------------------------#
#----------------------------------#
#----------------------------------#
#----------------------------G-----#
#----------------------------------#
#----------------------------------#
####################################