8
1
####################################

#----------------------------------#

#----------------------------------#

#----------------------------------#

#----------------------------------#

#----------------------------------#

#----------------------------------#

#----------------------------------#

#----#-----------------------------#

#----#-----------------------------#

#----#-----------------------------#

#----#-----------------------------#

#----#--------2u-------------------#

#----#-----------------------------#

#----#-----------------------------#

#----#-----------------------------#

#----#-----------------------------#

#----------------------------------#

#----------------------------------#

#----------------------------------#

#----------------------------G-----#
#----------------------------------#

#----------------------------------#

####################################