####################
#------------------#
#------------------#
#------------------#
#----------A-------#
#------S-----------#
#---------------G--#
#------------------#
#------------------#
#------------------#
####################